........................................................................................................................................................................................................
........................................................................................................................................................................................................
........................................................................................................................................................................................................
........................................................................................................................................................................................................
........................................................................................................................................................................................................
........................................................................................................................................................................................................
........................................................................................................................................................................................................
........................................................................................................................................................................................................
........................................................................................................................................................................................................
........................................................................................................................................................................................................
........................................................................................................................................................................................................
........................................................................................................................................................................................................
........................................................................................................................................................................................................
........................................................................................................................................................................................................
........................................................................................................................................................................................................
.................................................................##################################............................................................#######################################..
................................................................########################################..................##################..................#########################################.
...............................................................##########################################...#####........#####################...........###############################################
..............................................................##################################################################################........################################################
...................................................#####################################################################################################################################################
..................................................######################################################################################################################################################
.................................................#######################################################################################################################################################
...............................................#########################################################################################################################################################
.............................................###########################################################################################################################################################
.............................###########################################################################################################################################################################
.........................###############################################################################################################################################################################
.....................###################################################################################################################################################################################
.......#########....####################################################################################################################################################################################
......##################################################################################################################################################################################################
.#######################################################################################################################################################################################################
########################################################################################################################################################################################################
########################################################################################################################################################################################################
########################################################################################################################################################################################################
########################################################################################################################################################################################################
########################################################################################################################################################################################################
########################################################################################################################################################################################################
########################################################################################################################################################################################################
########################################################################################################################################################################################################
########################################################################################################################################################################################################
########################################################################################################################################################################################################
########################################################################################################################################################################################################
########################################################################################################################################################################################################
########################################################################################################################################################################################################
########################################################################################################################################################################################################
########################################################################################################################################################################################################
########################################################################################################################################################################################################
########################################################################################################################################################################################################
########################################################################################################################################################################################################
########################################################################################################################################################################################################
########################################################################################################################################################################################################
########################################################################################################################################################################################################
########################################################################################################################################################################################################
########################################################################################################################################################################################################
########################################################################################################################################################################################################
########################################################################################################################################################################################################
########################################################################################################################################################################################################
########################################################################################################################################################################################################
########################################################################################################################################################################################################
########################################################################################################################################################################################################
########################################################################################################################################################################################################
