....................
...######...........
..######............
..#....#..######....
..#....#............
..######.######.....
....................
