........................................................................................................................................................................................................
........................................................................................................................................................................................................
........................................................................................................................................................................................................
........................................................................................................................................................................................................
........................................................................................................................................................................................................
........................................................................................................................................................................................................
........................................................................................................................................................................................................
........................................................................................................................................................................................................
........................................................................................................................................................................................................
........................................................................................................................................................................................................
........................................................................................................................................................................................................
........................................................................................................................................................................................................
........................................................................................................................................................................................................
........................................................................................................................................................................................................
........................................................................................................................................................................................................
........................................................................................................................................................................................................
........................................................................................................................................................................................................
........................................................................................................................................................................................................
........................................................................................................................................................................................................
........................................................................................................................................................................................................
........................................................................................................................................................................................................
........................................................................................................................................................................................................
........................................................................................................................................................................................................
........................................................................................................................................................................................................
........................................................................................................................................................................................................
........................................................................................................................................................................................................
........................................................................................................................................................................................................
........................................................................................................................................................................................................
........................................................................................................................................................................................................
........................................................................................................................................................................................................
........................................................................................................................................................................................................
........................................................................................................................................................................................................
........................................................................................................................................................................................................
........................................................................................................................................................................................................
........................................................................................................................................................................................................
........................................................................................................................................................................................................
........................................................................................................................................................................................................
........................................................................................................................................................................................................
........................................................................................................................................................................................................
........................................................................................................................................................................................................
........................................................................................................................................................................................................
...............................................................................................................................................................................GG....G..................
...........................................................................................................................................................................GG...........................
.................................................................................................................................................................GGG...G...LDGGG.........GG.G...........
...............................................................................................................................................GGGG......GGGGGGGGDDR.......LR.LR........GDR..G....GGGGGG
.......................................GGGGGGGG.......GGG...............................................GGGGGGGGGG...........................GGDDDDGGGGGGDDDDDDDDDDDGG...................L...LGGGGDDDDDD
.....GGGG.........G....GGGGGGGGGGGGGGGGDDDDBR..........LDG.....................................GGGGGGGGGDDDDDDDDDDGGGGGGGGGGGGGGGGGGGGGGGGGGGDDDDDDDDDDDDDDDDDDDDDDDDDG.......G..............LDDDDDDDDDD
....GDDDDGGGGGGGGGR...GDDDDDDDDDDDDDDDDDDDR.............LBG..................................GGDDDDDDDDDDDDDDDDDDDDDDDDDDDDDDDDDDDDDDDDDDDDDDDDDDDDDDDDDDDDDDDDDDDDDDR.......GR.G...........GDDDDDDDDDDD
...GDDDDR..LDDDDDDDG..LDDDDDDDDDDDDDDDDDDBR....G............................................GDDDDDDDDDDDDDDDDDDDDDDDDDDDDDDDDDDDDDDDDDDDDDDDDDDDDDDDDDDDDDDDDDDDDDDDR........LR........G.G.GDDDDDDDDDDDD
.GGDDDDDR..LBDDDDDDR..LDDDDDDDDDDDDDDDDDR......L.....G.........G...........................GDDDDDDDDDDDDDDDDDDDDDDDDDDDDDDDDDDDDDDDDDDDDDDDDDDDDDDDDDDDDDDDDDDDDDDDDR.G......LDG..G........LDDDDDDDDDBBD
GDDDDDDDBG...LDDDBBR.GDDDDDDDDDDDDDDDDDR......GR..GG...........LGGGGGGGGGG................GDDDDDDDDDDDDDDDDDDDDDDDDDDDDDDDDDDDDDDDDDDDDDDDDDDDDDDDDDDDDDDDDDDDDDDBBDR.L....G.LDDG.LG........LDDDDDDDR..L
DDDDDDDR.....LDDR..L..LDDDDDDDDDDDDDDDDR....G.L..........GG.GGGDDDDDDDDDDDG..............GDDDDDDDDDDDDDDDDDDDDDDDDDDDDDDDDDDDDDDDDDDDDDDDDDDDDDDDDDDDDDDDDDDDDDDR..LR.LGGGGDGDDR...L.......GDDDDDDDDR..L
DDDDDDDDG..GGBBBR.....LDDDDDDDDDDDDDDDBR........GGGGGGGGGDDGDDDDDDDDDDDDDDDGG....GGGGGGGGDDDDDDDDDDDDDDDDDDDDDDDDDDDDDDDDDDDDDDDDDDDDDDDDDDDDDDDDDDDDDDDDDDDDDDR......LDDDDDDDDR...LGG......LDDDDDDDR..L
DDDDDDDDDG.........GGGDDDDDDDDDDDDDDDR.....G..GGDDDDDDDDDDDDDDDDDDDDDDDDDDDDDGGGGDDDDDDDDDDDDDDDDDDDDDDDDDDDDDDDDDDDDDDDDDDDDDDDDDDDDDDDDDDDDDDDDDDDDDDDDDDDDDDR.G..G.LDDDDDDDDDG..LBBG.....LDDDDDDDR..L
DDDDDDDDDR....GGGGGDDDDDDDDDDDDDDDDDDR.....LGGDDDDDDDDDDDDDDDDDDDDDDDDDDDDDDDDDDDDDDDDDDDDDDDDDDDDDDDDDDDDDDDDDDDDDDDDDDDDDDDDDDDDDDDDDDDDDDDDDDDDDDDDDDDDDDDDDR..GGDGDDDDDDDDDDDG..........LDDDDDDR...L
DDDDDDDDDR.GGGDDDDDDDDDDDDDDDDDDDDDDDDG.....LDDDDDDDDDDDDDDDDDDDDDDDDDDDDDDDDDDDDDDDDDDDDDDDDDDDDDDDDDDDDDDDDDDDDDDDDDDDDDDDDDDDDDDDDDDDDDDDDDDDDDDDDDDDDDDDDDDR...LDDDDDDDDDDDDDDGGGGGG..GGBDDDBBR....L
DDDDDDDDDDGDDDDDDDDDDDDDDDDDDDDDDDDDDR......LDDDDDDDDDDDDDDDDDDDDDDDDDDDDDDDDDDDDDDDDDDDDDDDDDDDDDDDDDDDDDDDDDDDDDDDDDDDDDDDDDDDDDDDDDDDDDDDDDDDDDDDDDDDDDDDDDDDGG..LDSDDSSSSSSSSDSSDDSS..LR.LBR.......L
DDDDDDDDDDDDDDDDDDDDDDDDDDDDDDDDDDDDDDG.G.GGDDDDDDDDDDDDDDDDDDDDDDDDDDDDDDDDDDDDDDDDDDDDDBBBBDDDDDDDDDDDDDDDDDDDDDDDDDDDDDDDDDDDDDDDDDDDDDDDDDDDDDDDDDDDDDDDDDDDDR...SSSDSSSSSSSSSDSSSSSSGR....L.......L
DDDDDDDDDDDDDDDDDDDDDDDDDDDDDDDDDDDDDR....LDDDDDDDDDDDDDDDDDDDDDDDDDDDDDDDDDDDDDDDDDDDDDR....LDDDDDDDDDDDDDDDDDDDDDDDDDDDDDDDDDDDDDDDDDDDDDDDDDDDDDDDDDDDDDDDDDDDSS...LSDSSDSDSDSSDDSSSSSS.....L..G.G..L
DDDDDDDDDDDDDDDDDDDDDDDDDDDDDDDDDDDDDR...GDDDDDDDDDDDDDDDDDDDDDDDDDDDDDDDDDDDDDDDDDDDBDDR..G..LDDDDDDDDDDDDDDDDDDDDDDDDDDDDDDDDDDDDDDDDDDDDDDDDSSSSDDDDDDDSSSSSSSSS...SDSSSSSSSSSSSDSDSSSR.....LGGR....S
DDDDDDDDDDDDDDDDDDDDDDDDDDDDDDDDDDDDR....SSSSDSSSSSSSSSSSDDDDDDDDDDDDDDDDDDDDDDDDDDDR.LBR....GDDDDDDDDDDSSSDSSSSDSDDDDDDDDDDDDDDDDDDDDDDDDDDDSSSSDSSDSSSDSDSSSDDSSS....SDSSSSSDSSSSDSSS........LR.S....S
DDDDDSSSSDDDDDDDDDSSSSSSSSSSDSDDSSSSSSG..SDSSSSDSSSDSSSSSDDDDDDDDDDDDDDDDDDDDDDDDDDDR...L...GBDSSSSSSDSSSSSSSDSSSDSSSSDSDSDSSSSSSSDSDDSSSSSSSSSSSDSSDDSSDDSSSSSSDR.....SSSSSDSDSSSSSSSDS...............S
DDDDSDSDSSSSSDSSSSSSDSSSSSSSDSDSSSSSSSS..SSSSDDSSSSDSSSSSDSSSDDDDDDDDDDDDDDDDDDDDDDBR.........SSSSDSSSSSSSSSSSDDSSSSDDSSSSDDSSDSSSSSSSSSSSSSDSSDSDSSSSSSSSSSSSSSSS..SGSSSDSSSSSSSDSDSSDSGS.....S.......L
DDDSSSDSSSSSSDSDSSSSSSSSSSSSSDSSSSSSSSS..SDDSDSSSSSDSSSSDSSSSDDDDDDDDDDDDDDDDDDDDDR........G..LSSSSSSSSSSDSDSSSSDSSSSSSSSSDSSDDSSSSSSSSSDSSSSSSSSDDSSDDSSDDDSSSSSS..LSSSSSSSSSDSSSSSDSDSSDSS...........S
DSDSSDSSSDSSSSSSSSSSSSSSSSDSSSSSSSSSDS...LSSSSSSDSSSSSSSDSSDSSSSDDDDDDDDDDDDDDDDDDR.......GS....SDSSSSSSDSSSSDSDSSSDSSSSSSSSSDDSSSSSSDSSSSSDSSSSSSSSSDDSSSSSSSSSSS..LSSSDDSSSSSDSSSDSSDDSSSSS..........S
SSSSSSSDDSSDSSSSSSDSSSSSSDDSSSSSSDSSDSSSSSSSSSDSDDSSDSSSDSSSDSSSSSDSSDSSSDDDDDDDDDDG....G..L...SSSSSSSSSSSSSSSSSSSSSDSDSSSSSSSSSSSSSSSSDSSSDSDSSDSSDSSSSSDSDSSDSSSSSSSSSSSSSSSSDDDSSDSSSSSSSDSSS.......L
SDSSSDDDSDDSSSSSSSSSSDSSSSSSSSSDSSSSDDSSSSDSDSSSSDSSDSDDSSDSDSDDSSSSSDSSSSSDDDDDDDDR.G...........SSDDSSSSSSSSDSSDSSSSSDSSSSDSSSDDSSSSSSSSDDSSSSSSSSSSSSSSSDDDSDSSSSSSSSSSDSSSSDSSDSSSSSDSSSSSSSS.......S
DDSDSSSDSSSSSSDDSSSSSDSSSDSSSSSSSSDDSSSSSSSSSSSBDSSSSSDSDSSDSDSDSSSSSSSSSSSSSDDDDSSSSSS.........SSSDSSSSDSSSSSSSSSDSSSSSDSSSSDDDSSSSDSSSSSSDSSSDSSSSSDSSSSSSDDSDSSSDSSSSSSSDSSSSSSSSSSSDSSSSSDDS.......S
SSDSDSSDDSSSSSDSSDSDSSSSSSSDSSDSDSSSSSDSSDS.....LSSSSSSSSDSSSSDSSSSSDDSSDSSSDSSDSDSDDS.........SSSSSSSSSSSSSSSDSSDSSSSSSSSSSSSSDSDSSSSDSDSSSSSSSSSDDDSSSSSSSSSSDSSSSSSSDSSSSSSSSSSSSSSDSSSSDSSSS.......S
SSDDSSSSSSDSSSSDSSSSSSSSDSSSSDSDSSSSSDSSDS.....SSSSSSSDSSSSSDSSSSSSDSSDSSSSSSSSSSSSSDSSS....S...LDSSSSSSSSSDSSSSSSSSSSSSDSDSSSDSDSSDSSDSSSSSSSSSSSSSSSSSSSSSSSSSSSSSDDSSSDSSDSSDSSSSSDSSSSSDSSSSSSSS...S
DSDSSDDDSSSSSSSSDSSSSDSSDSDSSSSSSSSSSSDDSSS.....SSDSSSSSSDSSSSDSDSSSSSSSSSSSSSSSSSSSSSS.....SSSSSSR.SSDSSDSSSSSSSSSSDSSSSDSSSDDSSDSSSSSSSDDSSSSDSSSDSSSSSSSSSDSDDSDSSSSSSSSSSSSSSSSSSSSSSSDDDSSSSDDS...S
DDSSDSSSSSSDSDSSSSSSDSDSSSSSSDSSSDDSSSSSR.........SSSSSSSSSSSSSSDSSDSSSSSSSSSSDSDSSDSDR.GGGSSSSDSS....SS.SSDSSSSSDSSSSSSSSSDSSSSDSSDSSDSDDSSSSSSSDDSSSSSSSSSSSSSSSSSSSSSSSSSSSSSSDSSSSDSSSSSSSSSDSSSS..S
DSDDSSSSSSSSDSSSSSSSSSSDSSSSDDSSSSSSSDSS..........SSSSSSDSDDSSSDSSDSSSDSSSSSSSDDSSDSSS..SDSDSSSSSS.......SSDSSSSSSSDSSSSSSDSSSSSSSSSDSSSSSDSSSSSSSDDSSDSSSSSSSSDSSSSDDSDSSSSSSDSDSSSSSSSSSDSSSSSSSSDS.SD
SDSDSSSSDSSSSSSSSSSSSSSSSSSSDSDSSSSS.SS...........LSSSSDSSSSDSSDDSDSSSSSDSSDSSSDSSSSSSS..SSDSSSBSR.S......LSSSSSSSSSSSSSSSSSSSSSSDSDSSSSSSSSDDSSSSSSSSDDSSDSDDSSSSDDSSSSSDSDSSDSSSSSSSSDSSSSSSDDSDSSSSSS
SSSSSSDSSSDSSSSDSSSSSSSSDSSSSDSSSSSS............SSSDSSSSSDSDSSSSSSSSSSSSBSSSS.SSSDSSDSSS.SSSSS..S.....GS...SSSSSSSSSSSDDSSSSDSDSDSSSSSSSSDSSSSSSSDDSDSDSSSDSSSSDDSDSDSSDDSDSSSSSSSSSSBSBSSDSSSSSSSSSDSDS
SSSDSSSSSSSSSDSSSSSDDDSSSSSSSSSDSSDS.......S..SGSSSDSDSSDSSSSSSDDSSSSSR...S....LSSSSSSSS.SDBS........SDS...LSSSSDSDDSDSDDSSDSSSSSSDDSSSSSSSSSSDDDDSSDSSSSSSSSSSSSSSDSSDSSSSSDSSSSSSSS...SSSSSSSSSSSSSSSS
SSSSDDSSSSSSSSSSSSSSSSSDSSSSDSSSSSSS..........SSSSSSDSSSSDDSSSSSSDSSSSR...L..GSSSDDSSSBS.SS........GSSSSSSSSSSSDSDSSSSSSSSSSSDSSSSDSSSSSSSDSSSDSSDDSSSSSDSSSSSDDSSSSSDSSSSSSSSDSSSR......SSSSDSSDSDSDSSS
SSSSSSSSSDSDSSSSSSSSSSDSSSDSSSDDBSS..SS.......SSDSDDSDSDDSSSSSSSSDDSS.....S..SSBSSS.S.......S.....SDSSSDSSDSDSSSSSSSSSSSSSSSSSSDDDSSSSSSSSSSSDSSDDDSSSSSSSDSDSSSSSSSSSDSSSSSSSSSSSS......SSSDSDSSDSSSSSS
SDSSSSDDSDDDSSSSSSDSSSSSDSSSSSSS.SS..SS.......SSSSDSSDDSSSSDSDSSSSSSR..G.SS...S.......SG....S.....LSSSSSSDSSSSSSSSSSSSSSSSSDDSSDSSSDSSSDDSDSSSSSSSDSSSDSSDSDSSSSSSSDDDSSDSSSSSSSSSR....SGSSSSSDSSSSSDSSS
SSDSSSSDSSDSSSSSSSDDSSDSSSDSSDBR....SSS.......SSSDSSDSSSSSDSSSSSSBS....S......S....S..SSSS..SSG...LSSDSSSSSSSSSSSSSSSSSSSDSSSSSDSSSSSSDSSSDSSDSDDDDSSSSDDSSSSSDSSDSSSDDDSSSSSDS.SSSG.G.SSSDSSSSSSDSSSSDS
SSSDSSSDSSSDDSSDSSSSSSSDSSSDSS...........S.....SSDSSSSDSSDDSDSSS..S....SS..SS...SSSSSSS..S.SSSSS.GSSSSSDDSDSSSSDSSSSSSDSSDSSSSSSSSSSSSDSSSSSSSSSSDSSSDSSSSSSDDSSSSSSDSSDSSSSSSS........SDSSSSDSSSSSSSSSS
SSSDSSSSDSSSSSSSSSDSSSSSSDSSDBSSS........SG.....SDSDSDSSSSSSSS....S...GSSSSSS.SSSSSSDSS....SSSSDSSDSSSSSSSSDDDSSSSSDSSSSDSSSSSSDSSSSSDSSSSSDSSSSSDSSSSSSSSSSDSSSDSSSSDSDSSDSS...........SSSDSSSSSSSSDDSD
SSDDSSSSSSSSSSSDDDDSSDSSSSSSS..L.................SSSSDSSSSSSSS......S.SSSDSSSSDSSDSSSSS..SSBSSSSSSDSDSSSSSSSSSSDDDSSDSSSSSSSSSSSDSSSDDSSSSSSSSSSSSDSSSSSSSSSSSDSSSSSSSSSSSSDS............SSS.SSSSDDDDSSS
DSSDDSSSSSSSSSSSDSSSSSSSSSSDR.....................SDSSSSSS...L....SGDSSSSSDSSSSSSDSSDSR.......SSDSSDDSSDSSSSSSDSSDSSSSSSSSSSSSSSSSSDSSS...SSDSSSSSSSDSSSSSDSSDSSSSSSSSSDSDSDSS..S........SS...SDSSSSSSDS
SSSSSSSDDSSSSSSSSSDSSSDSDSSSR.......S....GS....SSGSSSSSDS.........SSDSSSSSSDSSSSSSDSSS...S....LSSSDSSDDSSSSSSSSSSSDSDSSSSDSDSDSSSSSDS....SDDSSSSSDSSSSSSSSSSDSSSSDSDSSSDSSDSSS...........SR....SSSSSSSDS
SSSDSSDSSDSSSDSSSSDDSSSDSSSS........SSS.SSR....SSSDDSSSSS...G.....SSSSSSSSSSDDDDSSSSS..........SSSSSSSSSSSS....SSSSDSSSSSSDDSDDR..SR.....SDSDSSSSSSSSSSSSDSSSDSSSSSSSDDDSSSSSS....G......SS...SSDSSSSSSS
SDDSSSSDSDDSSSSSDSSSSDSSDSSSS....S...SSSDSSSGGSSSSDSSSSSR.......GSSSSSDSDSSSSSSSSSSSS..........SSSSDSSS.SS....GSDSSDDDDSSSSDSSSS........SSSDSDDSSDSSSSSSSSSSSSSDSSSSDSDSSSSSSS.....S........S..SSSDSSSSS
DDSDSSSSSSDSSDSSSSSSSSDSSSSSSS..GSSSSDSSSSSSSSSSSSSDSDSS........SDSSSSSSSDSDSDSSSSSSDS..........LDSS.....S.....LSSSSSSSSSSSSSSSR.....SSSDSSSSSSDSSSSDDSSDSSDDDSSSSSDSDSDSSSDSS.....L...S.......SSSSDSSSS
SDDSSDSSSDSSDSDSSSSSSSSSSSDSSSSSDSSSSSSSSSSSSSSSSSSSSSSR.......SSSSSDDDSSSSSSDSSSSSSSSGS.......SBSDS.SS...........SSSSSSSDSDSS.........SSSSSSSSDSDSSDSSDDSSDSDSSSSDSSSSSSSDSSS.GS......S.....S...SBSSDSS
DSDSSSSSSDSSSSSSSDSDSDSSSDDDDSSDSSDSDSSSDSSDSSSDSSDSDSSSS......SSSDSSSSDDSDSSSSSSSSSDDSDS..S.....SSS.LSS.............SSSDSSSSS......S.GSSSDDSSSSSDSSSDSDSDSSSSSSSSSSDSSSDDSSSSGSS....SSS...........SSDSS
SSSDSSSDSSDSSSSSSDDDDSSDSSSSSSDSSSSSSSSSDSDSSSSSSSSSSSDDS......SSSSSSSSSSDSSSSSDSSSSSSSSSSSS.........SSS.............LSSSSSS........S....SSSDSSSSSSSSSSSSDSDDSSDDSSDSSSSDSSSSSSDSGSG.S........S....LSSSS
SSSSSDSSSDSSSSDSSSDDDSSSSSDSSSSSDSSSSSDSSSSSSDSDSDSDDSSSSSG.S.SDDSSSSSDSSSSSSSSSSDDSSDSDDSSR........GDSR.........SS...SR.S...SS.....L.S...SSSDSSDSSSSDSSDSSDSSSDSSSSSDSSSSDSSDSDSSS.........S.S.SSGSSDSS
DDSSSSSDSSSSDSSSDSSSSDSDDSSSSSDSSSDDSSDSSDSSSSSSDDSSDSDSSSSSDSSDSSSSSSSSDSDSSSSDDDDSDSSSSSS..G......SDSSS.S......SR...LS...SS......SR......SSSSSSSDSSSDSDSSSSSSSSSSSSSDSSSSSSSSSSSS..S..........SDDSSSSS
SSDSSDDDSSSSSSDSSDSSSDSSSSSSSDDSSSDSSSSSSDSSSSDDSSSSDDDSDSSSDSSSDSSSSSSSDDSSSSSSSDSDSDSSSS.........SSSSS..........S...SS.SGSS.S.....SS....SSSSSDSSSDSSDDSSSSDSSSSSSSSDDSSSSSSSDSSSSGGDSS........SSSSSSDS
SSSDSSSSSDSDSSDSSSSSSSSSSSSSSSSSSSSSDSSSDSSDSSDSDSSSSSDDSSSDSSSSSSSSSSSSSSSSSSSSSSDDSS.......S......LSSDS..S.......SG...............SS...GSSDSSSSSSSDSSSSSDSSSSSSSSSSSSSSSDSDSSDSSSSSSDSS.....GSDDSSSSSS
SSSSSSSSDSSSSSSSDSSSSSDSSSDSSSSSSSSSSSDSSDSDDSSSSSSSSSDSSSSSDDSSSSSSSSSDDSSDSSDSSDSSSR.............SSSSSSSSSS.......LS..............SS...SSSSSSSSSSSSDSSSSSSSSSSSDSSDSSSSDSSSSSSSSSSDSSSSSSSGSSSDSSDDDSS
DSDSSSSSSSSSSDSSSSSSSSSSSSSSSSSSSDSDSSSSDSSSSDSSDSSDSDSSSDSSSDSSSSSSSSDSSSSSDSSSSSSSSSG............SSSSSDS....SSGSS..S..............S...SDSSSDSSSSSSDSSSDSDSDDSSSSSSSDSSSSDDDDSSSSSDDDSSSSSSSDDDSSSDSSSS
DSSDSDSDSSSSSSSSSSDDSSSSSSSSSSDSSSSSSSDSSSSSSSSSSSSSSSDDSSSSSDSSSSSSSSDSSDSSSSDDSSSSSSR...........GSSSDSSSS...SSSSSS...........S.SSGS...LSSSSSSSSSDSDDDSSSSSSSSSSSSSSSSDSSSDDSSDSSDSSSSSDDSDDSSSSDSSSSDS
SSSSSDSSDSSSDSSDSSSSSSDSSDSSSSDSDSSSSSSSSSSSSDDSSSSDSSSSSDDSSSSSDSSDSSSDSSSSSSSSSSDSSDS............SSDSSSSSS...SSSSSSS.........SSSSSS...SSSDSDSSDDDSSSSSDDSSSSSSSSSSSSSSSDSSSSDSSDSSSSSSSSSDDDDDSSSSSDSD
SSSDSDSDDDSSSSSSSSSSSSDSSDSSDDSSSSDSDSSDDSSSSSSDDSSSSSSSSSSSSSSSSSSSSSSSSSSDSSDSSSSDSSSSSSSSGSGSSSGDSDDSSSSSGSSSSSSSSSSSSGSSSGSSSSSSSSG.SSSSSDSSSSSSSSSDSSSSDSDSSSDSDSSSDDSSDSSDDSDSDSSSSSSDSSSSSSSDSSSD
