....................................................................................................
....................................................................................................
....................................................................................................
....................................................................................................
....................................................................................................
....................................................................................................
....................................................................................................
....................................................................................................
....................................................................................................
....................................................................................................
....................................................................................................
....................................................................................................
....................................................................................................
....................................................................................................
....................................................................................................
....................................................................................................
....................................................................................................
....................................................................................................
....................................................................................................
....................................................................................................
....................................................................................................
....................................................................................................
....................................................................................................
....................................................................................................
....................................................................................................
....................................................................................................
....................................................................................................
....................................................................................................
....................................................................................................
....................................................................................................
....................................................................................................
....................................................................................................
....................................................................................................
....................................................................................................
....................................................................................................
....................................................................................................
....................................................................................................
....................................................................................................
....................................................................................................
....................................................................................................
....................................................................................................
....................................................................................................
....................................................................................................
....................................................................................................
....................................................................................................
............E.......................................................................................
..........EEEEE.....................................................................................
..........EEEEE.....................................................................................
.........EEEEEEE....................................................................................
..........EETEE.....................................................................................
GGGGGG....EETEE.....................................................................................
DDDDDDG.....T.........................................................................E.............
DDDDDDDG....T.......................................................................EEEEE..E........
DDDDDDDDGGGGMGGG....................................................................EEEEEEEEEE......
DDDDDDDDDDDDDDDDG..................................................................EEEEEEEEEEE......
DDDDDDDDDDDDDDDDDG..................................................................EETEEEEEEEE.....
DDDDDDDDDDDDDDDDDDGGG...............................................................EETEEEETEE......
DDDDDDDDDDDDDDDDDDDDDGGGGG.....................GGGGGG.................................T..EETEE......
DDDDDDDDDDDDDDDDDDDDDDDDDDGGGGGGGGGGGGGG....GGGDDDDDDGGGG.............................T....T........
DDDDDDDDDDDDDDDDDDDDDDDDDDDDDDDDDDR..........LDDDDDDDDDDDGG.......GGGGGGGGGGGGGG...GGGMG...T........
DDDDDDDDDDDDDDBBBDDDDDDDDDDDDDDDDDR...........LDDDDDDDDDR.......GGDDDDDDDDDDDDDDGGGDDDDDGGGMGG......
DDDDDDDDDDDDDR...LBDDDDDDDDDDDDDDDR....G......LDDDDDDDDDR.G...GGDDDDDDDDDDDDDDDDDDDDDDDDDDDDDDG.....
DDDDDDDDDDDDR......LDDDDDDDDDDDDDDR...........LDDDDDDDDDR....GDDDDDDDDDDDDDDDDDDDDDDDDDDDDDDDDDG....
DDDDDDDDDDDDDGG.G..LBDDDDDDDDDDDDDDG...G...GGGDDDDDDDDDDDG..GBDDDDDDDDDDDDDDDDDDDDDDDDDDDDDDDDDDGGG.
DDDDDDDDDDDDDDR......LDDDDDDDDDDDDDDGG.L...LDDDDDDDDDDDDDDG...LDDDDDDDDDDDDDDDDDDDDDDDDDDDDDDDDDDDDG
SSSSSDDDDDDDDDR.......LDDDDDDDDDDDDDDBGBGG.LDDDDDDDDDDDDDR....LDDDDDDDDDDDDDDBDDDDDDDDDDDDDDDDDDDDDD
SSSSSSSDDDDDDDDG......LDDDDDDDDDDDDDR...LR.LDDDDDDDDDDDDDR..G.LBDDDDDDDDDBBBR.LDDDDDDDDDDDDDDDDDDDDD
SSSSSSSSDDDDDDDR.......LDDDDDDDDDDDR.......LDDDDDDDDDDDDDDGGR...LBDDDDBBR......LDDDDDDDDDDDDDDDDDDDD
SSSSSSSSDSSDSSSS...G.G.LDDDDDDDDDDBBG.....GDDDDDDDDDDDDDDDDDDG....LBDR........GDDDDDDDDDDDDDDDDDDDDD
SDSSSSDSDSSSSSSS...LGDGDDDDDBBBBBR..L....GDDDDDDDDDDDDDDDDDDDDG.....LR.G...G..LDDDDDDDDDDDDDDDDDDDDD
SSDSSDSSSSSSSSDS...LDDDDDBBR..........GGGDDDDDDDDDDDDDDDDDDDDDDGGGG.LR.........LDDDDDDDDDDDDDDDDDDDD
DSSSSSSSSSSSSSSDS...LDDDR..........GGGDDDDDDDDDDDDDDDDDDDDDDDDDDDR..LR.G.......LDDDDDDDDDDDDDDDDDDDD
SSSSDDSSSSSSSSSSR...LSSDS......G....LDDDDDDDDDDSSSSSDDDDDDDDDDDDDDG....LG......LBBDDDDDDDDDDDBBDBDDD
DSDSDSSDSSSSSSSSS..GSSSSSSSS.........LSSDDDDSSSSSSSSSSDSSDDDDDDDDDR..GGDR.....GR..LDDDDBBBBBR..L.LDD
DDDDSSSSSSSDSSDSR...SDSSDSDS.GGS.....SDSSSSDSSDSSDDSSSSSSSSSSSSSSSDGSSSSS......S..LSSDS...........LD
DSSSSDSSSDSDSDDSS....SSSDSSS.SSSSS..SDSSSSSSSDSSSSDSSSSSDSDDSSSSSDSSSDSSSS........SSDSS....SSS..GGDD
SSSSSSSSSSSSSSDS.......SSSSSSSSSSDSSSSSDSSSSSSSSDDSSSSSSSSSSSDSSSSDSDSDSSDG......GSSSS.....SSR..LDDD
SSSSSSSS......S........SSSSSSSDDSDDSSSDSSSSDSSDSSSSSSSSSSSDSDSSSSSSSSSSSSS........SSSS....SSSS..LDDD
SSSSDSS....SG.SGSSGS...SSDDSSDSSSSSSSSDDSSSSSSDDSSSDSSDSSSSSDSDDSSSDSSSDSSG...S.......S...LDDSG.SSDD
SSSSSSS...SS..LSDSDSG.SDSDSSSSSSSSSDSSSSSSSSDDSSSSSSSSSSDDDSSSSSDSDSSSSDSDS...S.....G....SDSSSSSSDDS
DDSDSSSG.SSSG..SBBSDS.LSSSSSDSDSSSSSSSSSSSDSDSSDDSSSSDSSSSDSSSSSSSSSSSDDSSS......S..L...SSSSSDDSSDSS
SDSSSDSDGDSSSS....SBR..SSSSSSDSSSSSDSDSSDSSSSSSSSSSSSSSSSDSSDSDDSDSSSSSDSSSSS.GGS..SS...SDSSSDSSDSSD
SSDSSSSSSSSSSDS.........SSSSSSDDSSDSSDSSSSSSDSSSSDSDSSSSSDSSSSSSSSSSDDSSSSSDS.LS..SSSSSGSSSSDSSSSSSD
DSSSSSSSSSDSSSR...SS.....SSSSSSSSSDSSSDSSSSDSSSSSSSSDSSSSSSSSDSDSSDSSSSSSDDSS.....SDSSSSSSSSSSSSSDSS
SSSSSSSSSSSDDSS.SGSDSSSSSSSSSSSDSDSSSSSSSDSSSSSSSSDSSSSSDSSSSSSSSSSSSDSDSSSSSSS..SSSDSSSSSSSSSSSSDSS
SSSSDDSSSSDSSSSSSDSSSDSSSSSDSSSDDSSSSDSSSSSSSSSSDSSSDSSDSDSSDSSSSDSSDSSDDSSSDSSSSSDDDSSSDSSSDSSSSSSS
SSSSSSSDDSDSDSSSSSSSSDDSSSSSSDDDSSSSSSSSDSSSSSSSDSSSSDSDSSSSSSSSSSSSSSSDDSDSSSSSSSSDDDSSSSSSSSSDSSSS
SSDDSSSSDSDSSSSSSSSSSSDSSSSSSSSSSDSSSSSSSSDSSSSSSSSSSSSSSSDSDSSSSSSSDSSSSSSDDSSSSSDSSDSSSSSSSSSSSSSS
DDSSSSSDSSSDSDSSDSSSSSSSSSDSSSSSSSSSSSDSDSDSSSSSSDSDSSSSSSSSSDSSSSSDSSDSSSSSDSSSDSSSDSDSSSSSSSSSSDSD
DDSSDSDSSSSSSSSSSSSDSSSSSSSSSSSSSSSSDSSSSSSSSSSSSDSSSSDDSSDSSSDSSSDSSSSSSDSSSSSSSSSSSSSSSSSSSSSSDSSS
SSSSDSDDSSSSSSSDSSSDSSSSDSSDSDSSSSSSSSDSSSSSSSSSSSSSSSSSSSDSSSSDSSSDDSSDSSSSSSSSSSSDSSDDSSSDSSSSSSSS
SSDSSSSSSSSSSDSSSSSSSSDSSSDSSSSDSDSSSSSSSSDDSSSSSSSSSDSSSSSSSSSSDDSSSSDSSSDSDSDSSSSSSSSDDSSDSSSSSSSS
SSDSSDSDSDSDSSSDDSSSSSSSSDSSSSSSSDDSSSSSSSDSDSSSDSSSSSSSSDSSSSSSDDSSSSSSSSSSSSDDDSSSSSSSSDSSDDDSSDSS
SSSDSSSSSSSSDSDSSSSSSDSSSSSSSDSDSSSSDSSSSSSSSSSSSSDDSSDDDSSSSSDSSSSSSSDSSSSSSSDSSSSDSSSSSSSSDSSSSSDS
SDSSSSSSSSDSSSSSSDSSDSDSDSSSSSSSSDSSSDSSSSDSSSSSSSDSSSSSDSSSDSSSSSSSSSSSSSSSSSSSSDSSDSSSSSSSSSSSSSSS
SSSSSSSDSSSSSSSDSSSSSSSDDSDSSSDSSSSSSDDSSSSSSSDSSDSSSSSSSSSSSSDDSDSSSSSSSSSSDSSDSSSSSSSSSDDDSSDSDSSS
SSSSSSSSSDSSSSSSSSSSSSSSSSSSSSSDSSSSSSSSSSSSSSSSSSSSSSSSSSSDSSSSDDDSSSDSSSDSSSSSSSSSSSSSSDSSDDSSSSSS
SDSSSSSSSSSSSSDSSSSSSSDDSDDSSSSSSSSSSSSSSSSSSSSSSSSSSSSSSDDDSSDSSSSSSSSSDSSSSSSSSSDSSSSSSSSSSSSSSSSS
SSSDSSSSSSSSSSSSDSSSSSSSDSDDDSDSSSSSSDSDDSSSSSSDSSSDSSSDSDDSDSSSSSDDDSSSSSSDSSSSSSDSSDDSSSSSSSDDSDDS
SDSDSSDSSSSSDSDSSSSSSSDSSSSSDSSSDDSSSSSSSSSSSDSSSSSSSSSSSSSSSSSSSDDSSSSSSSSSSSSSSSSSSDSSDSSSSSSSSSSS
ITEM banana 52 56
ITEM banana 44 57
ITEM banana 36 57
ITEM banana 62 58
ITEM banana 61 58
NPC bro 50 56
