....................................................................................................
....................................................................................................
....................................................................................................
....................................................................................................
....................................................................................................
....................................................................................................
....................................................................................................
....................................................................................................
....................................................................................................
....................................................................................................
....................................................................................................
....................................................................................................
....................................................................................................
....................................................................................................
....................................................................................................
........................................E...........................................................
......................................EEEEE.........................................................
................................E.....EEEEE....................E....................................
..............................EEEEE..EEEEEEE.................EEEEE..................................
..............................EEEEE...EETEE..................EEEEE..................................
.............................EEEEEEE..EETEE.................EEE..EE.................................
..............................EETEE.....T....................EE.....................................
...................GG.........EETEE.....T....................EET....................................
.......GGGGGGGG....L............T.GGGGGGMGGGGGGGGGGGGG..............................................
.GGGGGGDDDDDDBBG..GR......G.....TGDDDDDDDDDDDDDDDDDDDDG....................GGGGGGGG.................
GDDDDDDDDBBBR.............LG.GGGMDDDDDDDDDDDDDDDDDDDDDDGGG....GM..........GDDDDDDDDG...GGGGGGGGGG...
DDDDDDDDR...............GGR..LDDDDDDDDDDDDDDDDDDDDDDDDDDDR..G.LDGGGGGG.....LDDDDDDDDGGGDDDDDDDDDDG..
DDDDDDDR.....G...........LDGGDDDDDDDDDDDDDDDDDDDDDDDDDDDDDG.LGDDDDDDDR....GDDDDDDDDDDDDDDDDDDDDDDDG.
DDDDDDDR....GBGG..........LDDDDDDDDDDDDDDDDDDDDDDDDDDDDDDR..LDDDDDDDDR....LDDDDDDDDDDDDDDDDDDDDDDDDG
DDDDDDDR..................LDDDDDDDDDDDDDDDDDDDDDDDDDDDDDDDGGDDDDDDDDDR....LDDDDDDDDDDDDDDDDDDDDDDDDD
DDDDDDDDG...GG.G..........LDDDDDDDDDDDDDDDDDDDDDDDDDDDDDDDDDDDDDDDDDDDGGGGDDDDDDDDDDDDDDDDDDDDDDDDDD
DDDDDDDDR..GDR.........GGGDDDDDDDDDDDDDDDDDDDDDDDDDDDDDDDDDDDDDDDDDDDDDDDDDDDDDDDDDDDDDDDDDDDDDDDDDD
DDDDDDDDDGGDDR.....G..GDDDDDDDDDDDDDDDDDDDDDDDDDDDDDDDDDDDDDDDDDDDDDDDDDDDDDDDDDDDDDDDDDDDDDDDDDDDDD
DDDDDDDBDDDDDDGG.GGDGGDDDDDDDDDDDDDDDDDDDDDDDDDDDDDDDDDDDDDDDDDDDDDDDDDDDDDDDDDDDDDDDDDDDDDDDDDDDDDD
DDDDDDR.LDBBDDDDGDDDDDDDDDDDDDDDDDDDDDDDDDDDDDDDDDDDDDDDDDDDDDDDDDDDDDDDDDDDDDDDDDDDDDDDDDDDDDDDDDDD
DDDDDR...L..LDDDDDDDDDDDDDDDDDDDDDDDDDDDDDDDDDDDDDDDDDDDDDDDDDDDDDDDDDDDDDDDDDDDDDDDDDDDDDDDDDDDDDDD
DDDDR.......LDDDDDDDDDDDDDDDDDDDDDDDDDDDDDDDDDDDDDDDDDDDDDDDDDDDDDDDDDDDDDDDDDDDDDDDDDDDDDDDDDDDDDDD
DDDDDGG...G.LDDDDDDSSSSSSDDDDDDDDDDDDDDDDDDDDDDDDDDDDDDDDDDDDDDDDDDDDDDDDDDDDDDDDDDDDDDDDDDDDDDDDDDD
DDDBBDR.G.S.SSDSSDSSSSDSDSDDDDDDDDSDSSSSDDDSSSSSSDSDSSDDDDDDDDDDDDDDDDDDDDDDDDDDDDDDDDDDDDDDDDDDDDDD
DSS..LS.S.S.SSSSSSSDSSSSSSSDDDDDDSDDDDDSSSSSSDSSSSSSSSDDDDDDDDDDDDDDDDDDDDDSSSSSSSSDDDDDDDDDDDDDDDDD
S..............SSSSSSSSSSDSSSSDSSSDDSSSDSSSSDSDSSSDSSSSSSSSSSSSDDDDDDDDDDSDSDSSSSDSSDDDSDDSDSSSSSDDD
R..............SSDSSSDDSSSSSSSSSSSSDSSSSSSSSDSDDSDSSSSDSSSSDSDSSSDSDDDSSSSSSSSSSSDDSSDSSSSSSDSDSDDDD
R...............SSDSDDDSSSSDDSSSSSSSSSDSDSDSSDSSDSSSSSSSSSSDSSSSSDSDSDSSSSSSDSSSSSSSSSDSSSSSSDSSSSSD
R................LSDDDSSSDSDDSSSSSSSSDSSSSDDSSSSDSSSSSDSSSDSSSSSSSDSSDSSSDSSSSSSSSDDSSSSSSDSSSSDSSSS
R................SSSSSSSDSSSSSSSDSDSSDDSSSSSSSSDSSSSSSSSSSSSSSSSSSSSSSSDDSSSSSSDSDSSSSSSSSSDSSSSSSSS
R..............SSSSSDSSSSDSSSSSSDDSSSDDSSSSSSDSSSDDSSSSSSSSSDSSDSDSSDSSDSDDSSSDSSDSSSSSSSSSSDSSSSSSS
S................SSSSDSSSDSSSSSSSSSDSDSSSDSSSSSSSSSSSSDSSSSSSSSSSSSDSSDSSSSSSSDSSSSSSSSSSSSDSDSSSSSS
DSGS...S.S........LSSSSDSDSDSSSDSSSSSSSSDDSDSSDSSSSSSSSSSSSSDDSSSSSDSSSSSSDSSSSSSSSSSSSSSSSSSSSSSSDS
SSSS..SS..........SSDSSDDSSSSSSDSDSSSSSSSSDSDSSSSSSSSSSDSSSSSSSDSSDSSSSSSDSDSSSDSSSDSSSSSSSDDDDSSSSS
DSSSGSSSSSSSSS.SSSSSSSDSSSSSSSSDDSSSSSSSSSSDSSDSDSSSDSSSSSSSSDSSSDSSDSDDSDSSSSSDSSSDSSDSSSDSSSSSSSSS
ITEM banana 73 24
ITEM banana 86 25
