....................................................................................................
....................................................................................................
....................................................................................................
....................................................................................................
....................................................................................................
....................................................................................................
....................................................................................................
....................................................................................................
....................................................................................................
....................................................................................................
....................................................................................................
....................................................................................................
....................................................................................................
....................................................................................................
....................................................................................................
....................................................................................................
....................................................................................................
....................................................................................................
....................................................................................................
....................................................................................................
....................................................................................................
....................................................................................................
....................................................................................................
....................................................................................................
....................................................................................................
....................................................................................................
....................................................................................................
....................................................................................................
....................................................................................................
........................................................................E...........................
......................................................................EEEEE.........................
......................................................................EEEEE.........................
.....................................................................EEEEEEE........................
......................................................................EETEE.........................
......................................................................EETEE.........................
........................................................................T....GGGGGGGGG..............
..................................................................GGG...T...GDDDDDDDDDGG............
...................................................................LDGGGMGGGDDDDDDDDDDDDGGGGGG......
.......................................E..........................GDDDDDDDDDDDDDDDDDDDDDDDDDDDG.....
.....................................EEEEE.....................G..LDDDDDDDDDDDDDDDDDDDDDDDDDDDDGGGGG
.....................................EEEEE........................LDDDDDDDBBBDDDDDDDDDDDDDDDDDDDDDDD
....................................EEEEEEE........................LBDDDDR...LBDDDDDDDDDDDDDDDDDDDDD
............E........................EETEE..........GGGGGG...........LDDR......LDDDDDDDDDDDDDDDDDDDD
..........EEEEE......................EETEE.........GDDDDDDG.......G..LBBBG..GG.LDDDDDDDDDDDDDDDDDDDD
..........EEEEE........................T.......GGGGDDDDDDDR......GR......LG....LDDDDDDDDDDDDDDDDDDDD
.........EEEEEEE.......................TGGGGGGGDDDDDDDDDDDDG.....LBG...........LDDDDDDDDDDDDDDDDDDDD
..........EETEE................GGGGGGGGMDDDDDDDDDDDDDDDDDDDR.......L...........LDDDDDDDDDDDDDDDDDDDD
..........EETEE...............GDDDDDDDDDDDDDDDDDDDDDDDDDDDDDGGG..G.LG.........GDDDDDDDDDDDDDDDDDDDDD
............T................GDDDDDDDDDDDDDDDDDDDDDDDDDDDDDDDDR.......G.......LDDDDDDDDDDDDDDDDDDDDD
............T...............GDDDDDDDDDDDDDDDDDDDDDDDDDDDDDDDDDDGGGG..GDG....G.LDDDDDDDDDDDDDDDDDDDDD
GGGGGGGGGGGGMGG............GDDDDDDDDDDDDDDDDDDDDDDDDDDDDDDDDDDDDDDDGGDDR..G...SSSSSSSSDDDDDDDDDDDDDD
DDDDDDDDDDDDDDDGGGGGGGGGGGGDDDDDDDDDDDDDDDDDDDDDDDDDDDDDDDDDDDDDDSSSSDDDGGDGGSSSSSSSSSSSDDDDDDDDDDDD
DDDDDDDDDDDDDDDDDDDDDDDDDDDDDDDDDDDDDDDDDDDDDDDDDDDDDDDDDDDDDDDDSDSSSSSDSSDSDSSSSSDSSSDDSSSSDSDDDDDD
DDDDDDDDDDDDDDDDDDDDDDDDDDDDDDDDDDDDDDDDDDDDDDDDDDDDDDDDDDDDDDDSSSSDSSSSDDSSDSSSSSSSSDSSDSSSSSSDDDDD
DDDDDDDDDDDDDDDDDDDDDDDDDDDDDDDDDDDDDDDDDDDDDDDDDDDDDDDDDDDDSSSDDSSSSSSSSSSSSSDSSSSDSDDSSDSSDSSSSSSS
DDDDDDDDDDDDDDDDDDDDDDDDDDDDDDDDDDDDDDDDDDDDDDDDDDDDDDDDDDDSDSSSDSSSSDSSSSSDSSDDDSSSSSSSSDSSSSDSSDSS
DDDDDDDDDDDDDDDDDDDDDDDDDDDDDDDDDDDDDDDDDDDDDDDDDDDDDDDDDDSSSSSSSSSSSSSSSSSSSSSSSSSSDDSSSSSSSSSSSSSD
DDDDDDDDDDDDDDDDDDDDDDDDDDDDDDDDDDDDDDDDDDDDDDDDDDDDDSSSSSSDSSDDSSSSSSDSSDSSSSSDSSSSSSSSDSSSSDSSSDSS
DDDDDDDDDDDDDDDDDDDDDDDDDDDDDDDDDDDDDDDDDDDDDDDDDDDSDSSSSSSSDSSSDSDSDSSDSDSDSSSDSSSSDDSSSDSSDSSSSDSS
DDDDDDDDDDDDDDDDDDDDDDDDDDDDDDDDDDDDDDDDDDDDDDDSSSDSSSSSSSDDDDDSSSSSSSDSSSSSSSSSSDSDSSSSDSSSSSSSDSSS
DDDDDDDDDDDDDDDDDDDDDDDDDDDDDDDDDDDDDDDDDSSSDSSSSSSSSDSSDSSDDSDDSDSSDSSDSSSSSDSSSSSDSSDSDSSSDSDSSSSS
DDDDDDDDDDDDDDDDDDDDDDDDDDDDDDDSSSSSDSSSSDSDSDSSSDSSSSSSSSSSSSDSDSSSSDDDSSSDSSSSDSDDSSSSDSDSSSSSSSDS
DDDDDDDDDDDDDDDDDDDDDDDDDDDDDDSSSSDSSSSSSSSSSSSSSSDSSSSSDSSSDSSSSSSDDSDSSSSSDSDSSSSSSDSSSDSSSSDDSSDS
DDDDDDDDDDDDDDDDDDDDDDDDDDDDDSSSSSDSSDSDSDDSSDSSSSDSSSDSSSSSSSSSSSSSSSDDSSSSDSSSSDDSSSSDSSSSSDDSSDDS
DDDDDDDDDDDDDDDDDDDDDDDDDDDDDSSSSDSDSSSSSSSDSSSSDSSSSSSSSSSSSDDSDSSSSDSSSSSSSSSSSSSSSSDDSSSSSSSSSSSS
SSSSSSDSSSDSSDDDDDDDDDDDDDDSSSSSSSSSDSDSSSDDSSDSDSSSSSDSSSSSSSSSSSSSDSSDDSSSSSDSSSSSDDDSSSSSSSDSSSSD
SSDSSSDSSDSSSSDDSDDSDDSSSSSSSSSSSSSDSSSDSSSSDSSSDDSDSSSDSSSSSSSSDSSSDDSSDSDDSSSDSSSSSSDDSSSSSSSSDDDD
SDSSSSSSSSDDSSDDSSDSSDSSSSSSSDDSSSSSDSSSSSSSSSSSDSSSSSSSSSDSSSSSDSSSSSDSSDDSSSSSDSSSSDDSSSDSSSDDSDSS
DSDSSSSSDSSSDSSSDSDSSSSSSDSSDSSSDSSSSSDDDSDSSSSSSSDSDSSSSSSSSDSDDSDSSSSSDSSDSSSSSSSDSSSDSSSSSSSSSSSS
SSDDDSSDSSSDSSSSSSSSSSSSSDDSSSSSSSSSSDSSDSSSSSSSSSSSSSSSSSSSSSSSSSSSSSSSSSSSSSSDSSDSSSSSSSSSSSSDSSSD
SSSSSDDSSS.SBSSS.SDSSSSSDSDSSSSSSSSSDSSDSSSSSSSSSSSSSSSSSDSDSSSSSSSSSSSSSDSSSSSSSDSSDSSSSDDSSDSSSDSS
DSSSSSSS.....SR...SSSSSBSSSSSSSDSSDSSSSSSSSSSSDSSSSSDSSDSSSSSDDSDSDSSSDSDSSSSDSSDDSSSSSSSDSSSSSSSSSS
SSDSSSS.......S..GS.SS..SDDSSSSDSSDDSSSSSSSDSSSDSDSSSSSSDSSSSDSSSSSSSSSSDSSSDSSSSSSSSDSSSSDSSDSSSSSS
DSSSSSS.......SG....LS...SSSSDSSDSSSSSSDSSSSSSSSDSSSSSDSSSDSSDDSSSSSSDSSSSSSSSDSSSSSSSDSSDSDSSSSSSDD
SSSDSSS..........S...S...SSSSSDSSSSSDDSSSDSSSSDSDSSSSSSSDDSSDSSSSSSSSSSSSSSSSSDSSSSSSSSSDDSDDSDDSSSD
SSSSBS.........S...S......SSSSSDSSSSSSSDSSSDDDSSSSSSSSDDDSSSSSSDSSSDSSDSSSSSSDSSDSSDSSSSSSDSSSSDSSSS
DSS..............SSS......LSDSSSSSDSSSSSSSSDSSSSSSSSSSDSSSSSSDSSSSDSSSDSSDSDDSSDSSDSSSSSSSSSSSDSSSSS
SSSG...........SGDSS......SSSSSSSSDSSSSDSSSSDSSSSSSSSSSSSDSSSSDSSSSSSSSSSSSDSSSDSSDDSSSSSDDDSSSSSDSS
DSDS...S....S..SSSDS.S...SSSDDDDSSSDSSDDSDSDSSDSSSSSSDSDSSDDSSSSSSSSDSSSSSDSSSDSSSSSSSDSSDDSDSDSSSSS
DSSSSSS........SSSSS.....SSSSSSSSSSSDSSSDSSDDSSSSSSSSDSSDSSSSDSSSSSSSSSDSSSSSDSDSDSSSDSDSSSSSSSSSDDS
SSSDSDS......SSSSDSSSSS.....SSSSSSSSSSDDSSSSSSDSSSSDSSSSSSSDSSSDSSSSSSSDDDSSSSSSDSDSSSSSSDSDSSSSDSSS
SDSSDSSSSSSS..SSSSDSSSR.....SSSSSDSSSSSSSSDSDSSSDSDSSSSSSSSSSSDSDSSSSDSDSSSSSSDDSSSSSSDSSSDSSSDSDSSS
SSSSSSSSDSDS..LSSSSDSSSSGSGGSDSSSSDSSSSSSSSSSDSSDSSSSSSSSSSSDSSSSSSSSSSSDSSSSSSSSSSSSSSSDSSSSSSSSSSS
SDSDSSDSSSSDSSSSSSSSSSDSDDSSDSSSSSSDSSSDDSSSSSSSSSSDDSSSSSSSSSSSSSSDDDSSSSSSSSSSDSDSSSSSSSSSSSSSSSDS
SSDSDSSSSDSSSSDSDSSSSSSSSSDSSSSSSSSSSSSSSSDSSSDDSDSDSSDDSDSDDSSDSDDSDSSSSSSSDSSSDSDSSSSSSSSDDSSDSSSD
SSSSSSSSSSSSSSSSSSDSSDDSSSSSSSSSSSSSSSSSSSSSSSSSSSSDDDSDDDSSSSSDSSSDSSSDDSSDSDSSSDDDSSSSSSSDSSSDSSDD
SSSSSSSSDSSSSSSSSSSDSDSSSSSSSSSSSSSSSSSSSSSSSSSSSSSSSSSSSSSSSSSSSDSSSSDSSSSSSSSDSSSSSDSSSSSSSDSSSSSS
SDSSDSSSSSSDSSSSSSSSDSDSSSSSSSDSDSSSSSDSDSSSSDSSDDDDSSDSSSSDSSDDSSSSSSSSSSSSSSSSSSSSDSSSSSSSDSDSSDSD
DSSSSDSDSSSSSSDSSSDSSSSSDSSSDSSDSSSSSSSSSDDDSDDSSSSSDSSSSSSSDSDDSSDSSDSSDDSDSDSSDSDSSDSDDSSSSSDDSSDS
SSSDSSSSSSDSSSSSDSSDDSSSSDSSSSSSSSDDDSSDSSSSSSDDSSSSSSDSSSSSSSSSSDDDSSSSSSDSDSSSDSDSSDDSSSSSSSSSDDSS
SSDSSDSSSSSDSDSSSSSDSSSSSSDSDSSSDSSDSSSSDSSSSSSSSSSSDDSSSSSDSDSSSSSDSDSSSDSDSSDDSSSDDSSDSDSSDSSDSSSD
SSSSSDSSSSSSSSSSSDSSSSSSDSSSSSDSSSSSSSSDSSSDSSSSSSSSSSSSSSSSSSSDSSSSDSSSSDSSSSSSSDSSSSSSDSSDSSDSDSSS
SSDSSSSSDSSSSSSDSSDSDSDDSSDSSSSSSSSSSSSDSSSSDSSSSSDSSSSSSDSSSSDSSSSSSSSSSSDSSSSSSDSSSSDDSDSSSSDDDSDS
SSSSSSSDDSSSSSDSSSSSSSDSSDDSSSSSDSDDSSSSSSSDSSDSSSSSSDSSSDSSSSSSDSSSDSSSSSSSSDSSSDSSSSDSSSSDSSSSDDSS
SSSSSSSSDSSSSDSSSDSSSSSSSSSSSSSDSSSSSDSSDSSSDSSDSSSDDSSSSSSSSDSDSSSSSSSDDSSSSSSDSDDSSSSDSSDSSSDSSSSD
SSDDSSSSSSDSSSSSSSSDSSSSSSSSSSSSSSDSSSDSSSSSDSSSSSSSSSSSSSSSSDSSDSSSDSSDSSSSSSSSSSSSSDDSSSSSSDSSDSDS
DDSSSSSSDSSSSSSSSSSSSSSSSSSSSDSDDSSSDSSSSSSSSSSSSDDSSSSDDSDSSDSSSSSDSSSDSDSDSDDDSSSSSSSSSSSSSDSDSSSS
DSSSSSSSDSDSDSSSSSDSSSSDSSSDDSSSSSDSSSSSSSSSSSDSSSSSSSSSDSSSSSDSDSSDSSSSDSSSSSSSSDSSSSSSDSDSSDSSSSDS
DSSSSSSSDSSSSSSSSSSSDSSSDSSSSSSSSDSDDSSDDSSDDSDSSDSSSSSSSSSSDSSSSSSSDDDDSSSSSSSDSSSSSSSSSSSSSSSSSSSS
SSDSSSSSDSSDSDDSSSSSSSDSSSSSSSSSDSSSDSSSSSDDSSSSDSSDDSSDSDDSSSSSSSSSSSSSSDSSSDSDDSSDSSSSSDSSSSDSSSSS
ITEM banana 4 49
ITEM banana 48 43
NPC bro 50 43
