....................................................................................................
....................................................................................................
....................................................................................................
....................................................................................................
....................................................................................................
....................................................................................................
....................................................................................................
....................................................................................................
....................................................................................................
....................................................................................................
....................................................................................................
....................................................................................................
....................................................................................................
....................................................................................................
........................................................................E...........................
......................................................................EEEEE.........................
.........................E............................................EEEEE.........................
.......................EEEEE.........................................EEEEEEE........................
..................E....EEEEE..........................................EETEE..............GGGG.......
................EEEEE.EEEEEEE.........................................EETEE..............LDDDGG.....
................EEEEE..EETEE............................................T................LDDDDDGGGG.
...............EEEEEEE.EETEE............................................T.....GG......G..LDDDDDDDDDG
................EETEE....T.....GGG.......................GGGGG........GGMGGGGGDR.......GGDDDDDDDDDDD
................EETEE....T....GDDDGGGG............G.GGGGGDDDDDG......GDDDDDDDDDDG.....GDDDDDDDDDDDDD
..................T..GGGGMGGGGDDDDDDDDGGG........G..LDDDDDDDDDDG....GDDDDDDDDDDDDGGGGGDDDDDDDDDDDDDD
GGGG....GGG.......T.GDDDDDDDDDDDDDDDDDDDDGGGG....L.GDDDDDDDDDDDDGGGGDDDDDDDDDDDDDDDDDDDDDDDDDDDDDDDD
DDDR.....LDGGGGGGGMGDDDDDDDDDDDDDDDDDDDDDDDBBGG....LDDDDDDDDDDDDDDDDDDDDDDDDDDDDDDDDDDDDDDDDDDDDDDDD
DBR.....GDDDDDDDDDDDDDDDDDDDDDDDDDDDDDDDDDR........LDDDDDDDDDDDDDDDDDDDDDDDDDDDDDDDDDDDDDDDDDDDDDDDD
R......GDDDDDDDDDDDDDDDDDDDDDDDDDDDDDDDBBR.........LDDDDDDDDDDDDDDDDDDDDDDDDDDDDDDDDDDDDDDDDDDDDDDDD
R......LDDDDDDDDDDDDDDDDDDDDDDDDDDDDDDR..........GGDDDDDDDDDDDDDDDDDDDDDDDDDDDDDDDDDDDDDDDDDDDDDDDDD
R.....GDDDDDDDDDDDDDDDDDDDDDDDDDDDDDDDR..G......GBDDDDDDDDDDDDDDDDDDDDDDDDDDDDDDDDDDDDDDDDDDDDDDDDDD
R....GDDDDDDDDDDDDDDDDDDDDDDDDDDDDDDDR............LDDDDDDDDDDDDDDDDDDDDDDDDDDDDDDDDDDDDDDDDDDDDDDDDD
R.GGGDDDDDDDDDDDDDDDDDDDDDDDDDDDDDDDDR...G........LBBBDDDDDDDDDDDDDDDDDDDDDDDDDDDDDDDDDDDDDDDDDDDDDD
R..LDDDDDDDDDDDDDDDDDDDDDDDDDDDDDDDDDDGG...GGG........LDDDDDDDDDDDDDDDDDDDDDDDDDDDDDDDDDDSDSSDDDDDDD
R..LDDDDDDDDDDDDDDDDDDDDDDDDDDDDDDDDDDR.......G.......LDDDDDDDDDDDDDDDDDDDDDDDDDDDDDDDDDSDSSSDDDDDDD
R..LDDDDDDDDDDDDDDDDDDDDDDDDDDDDDDDDDR........LGG....GBDDDDDDDDDDDDDDDDDDDDDDDDDDDDBBDSDSSSSSSSSBSSD
R..LDDDDDDDDDDDDDDDDDDDDDDDDDDDDDDDDR.....G....L.......LDDDDDDDDDDDDDDDDDDDDDDSDSSS..SSDSDSSDSSS...S
R..LDDDDDDDDDDDDDDDDDDDDDDDDDDDSSSDBR......GG.GR...GG.GDDDSSSDDDDDDDDDSSSSDSDDSSS......SSSDSSSSSS..S
R..LDDDDDDDDDDDDDDDDDDDDDDDDDDSDSSR.......GDDGDDGGSSSSDSDSSDDDSDDDDDDSSSSSSSSSSSS......SSSSSSDSDS..L
R..LDDDSSSDDDDDDDDDDDSSSSDSDSSDSSSS.G.....LBDDDDSSSSSSDSSSSDSSSSDDDDSSDDSSSDDSDSS...S.SSSSDSSSSSR..S
S..SSDSSSSDDDDDDDDDDSSDSSSSSDSSSDSS.........SSSSSSSSSSSSSSDSSSDSSSDSSSSSSSSDDSSSR...S.SBSSSSSSSSDS.S
DS.SDSSSSDSSSDSSDSSSSSSDSSSDSSSSSSS..........LSSSSDDSSSSSDSSSSSSSDSSSDSDSSDDDSSDSSS.S...SDSSSDSSDS.L
S..SDSSSDDSSSSSSSSSSSSDSSSSDSSDSSDS....SSSS..SSSSSSSSSSSSSSSDSDSSSSDSSDSSSSDSSSSSSR......SSSSDDSR..S
SG.SSSSSDSSDSSSS.SDSSSDDDDSSSSSDSSSSGGSSSSSSSSSSSSSSDDSSSDSSDSSSDSSSSSSSSSSSDSSSSSS.GS...SDSDSSS..SD
SS....SSSSSDSSS..SSDSSSSSDSDSSDSSSSSSSSSSSDDDDSSSSSDSSSSSSSDSSSSSSSSSSDSSSSSDSSSSSSS.L...SSSSDSS..SD
SSS....SSDSS.S..SDDSSSSSSDSSSSSSSDSSSDSSSSSSSSSSSDDSSSDDDSSSSSSDSSSSSDDSSSSSSSSSSSSS.......LSSSS..SS
SSDGS...SS......LSDSSSSDSSSDDSDSSDSSDSSSSSSSDSSSSSDSSSSSDDSSDSSSSSSSDSSDSDSSDSSSSS...........SSS...S
DSDSDS..........LSSSSSDSSSSDSSSSSDDSDSSSSSSSDSSSSSSSSSDSDSSDSSSSSSSSDSSSDSDSSSSSSS.S.........S.....L
SSSSDSS.........SDSSDSSSSSDDSSSSSSDSSSSSSDDSDSSDSDSSSSSSSSSSSSSSSDSSSSSSDDSSSSSSS..............S...L
SSSSSSSSSGGSSSSSSSSSDSSDSSSSSSSSSSSSSSSSSSDSDSSSSSSSSSDDSSSSSSDDSSSSSSSSSSSSSSSSSSSGSSSGSSSSSSSSSSGS
ITEM banana 19 25
ITEM banana 4 24
ITEM banana 41 24
