....................................................................................................
....................................................................................................
....................................................................................................
....................................................................................................
....................................................................................................
....................................................................................................
....................................................................................................
....................................................................................................
....................................................................................................
....................................................................................................
....................................................................................................
....................................................................................................
....................................................................................................
....................................................................................................
....................................................................................................
....................................................................................................
....................................................................................................
....................................................................................................
....................................................................................................
....................................................................................................
....................................................................................................
....................................................................................................
....................................................................................................
....................................................................................................
....................................................................................................
....................................................................................................
....................................................................................................
....................................................................................................
....................................................................................................
....................................................................................................
....................................................................................................
....................................................................................................
....................................................................................................
....................................................................................................
..................................................E..........E......E...............................
................................................EEEEE......EEEEE..EEEEE.............................
................................................EEEEE......EEEEE..EEEEE.............................
...............................................EEEEEEE.....E.EEEEEEEEE..............................
................................................EETEE.............EET...............................
................................................EETEE.......E......E................................
..................................................T..........T......................................
..................................................T..........T.........GGGGG................GGGG....
.............................................GGGGGMGGGGG...GGMGGGG.....LDDDDGGGGG..........GDDDDG...
...............................GGGG........GGDDDDDDBBBR..GGDDDDDDDGGGGGDDDDDDDDDDGGGG..GGGGDDDDDDG..
..............................GDDDDGGGGGGGGDDDDDDDR......LDDDDDDDDDDDDDDDDDDDDDDDDDDR..LDDDDDDDDDDG.
.............................GDDDDDDDDDDDDDDDDDDDDDGG....LDDDDDDDDDDDDDDDDDDDDDDDDDDR..LDDDDDDDDDDDG
..........................GGGDDDDDDDDDDDDDDDDDDDDDDDR....LDDDDDDDDDDDDDDDDDDDDDDDDDDR..LDDDDDDDDDDDD
...........................LDDDDDDDDDDDDDDDDDDDDDDDR...GGDDDDDDDDDDDDDDDDDDDDDDDDDDR..GDDDDDDDDDDDDD
......................GG...LDDDDDDDDDDDDDDDDDDDDDDR....LDDDDDDDDDDDDDDDDDDDDDDDDDDR...LDDDDDDDDDDDDD
...................GGGDR..GDDDDDDDDDDDDDDDDDDDDDDR.....LDDDDDDDDDDDDDDDDDDDDDDDDDDR.GGDDDDDDDDDDDDDD
GG......GGGGGGG...GDDDDR..LDDDDDDDDDDDDDDDDDDDDDDDG..GGDDDDDDDDDDDDDDDDDDDDDDDDDDDDGDDDDDDDDDDDDDDDD
DDGGGGGGDDDDDDDGGGDDDDDDG.LDDDDDDDDDDDDDDDDDDDDDDDDGGDDDDDDDDDDDDDDDDDDDDDDDDDDDDDDDDDDDDDDDDDDDDDDD
DDDDDDDDDDDDDDDDDDDDDDDDR.LDDDDDDDDDDDDDDDDDDDDDDDDDDDDDDDDDDDDDDDDDDDDDDDDDDDDDDDDDDDDDDDDDDDDDDDDD
DDDDDDDDDDDDDDDDDDDDDDDDR.LDDDDDDDDDDDDDDDDDDDDDDDDDDDDDDDDDDDDDDDDDDDDDDDDDDDDDDDDDDDDDDDDDDDDDDDDD
DDDDDDDDDDDDDDDDDDDDDDDDR.LDDDDDDDDDDDDDDDDDDDDDDDDDDDDDDDDDDDDDDDDDDDDDDDDDDDDDDDDDDDDDDDDDDDDDDDDD
DDDDDDDDDDDDDDDDDDDDDDDDR.LDDDDDDDDDDDDDDDDDDDDDDDDDDDDDDDDDDDDDDDDDDDDDDDDDDDDDDDDDDDDDDDDDDDDDDDDD
DDDDDDDDDDDDDDDDDDDDDDDDDGDDDDDDDDDDDDDDDDDDDDDDDDDDDDDDDDDDDDDDDDDDDDSDSSDSDDDDDDDDDDDDDDDDSSSSDDDD
DDDDDDDDDDDDDDDDDDDDDDDDDDDDDDDDDDDDDDDDDDDDDSDSDSSDSSSSSDSDSSSSSDSSSSSSDSSDSSSSSDDDDDDDDDDSSDDSSDDD
DDDDDDDDDDDDDDDDDDDDDDDDDDDDDDDSSSSDDDDDDDDSDSSDSSSSSSSDSSSDSSSSSSSSSSSSSSSSSSSDSDSSSSSDSDSSSSSSSSDD
DDDDDDDDDDDDDDDDDDDDDDDDDDDDDDSSDSDSSSSSSDSSSSSSDSSSSSSSSDSSSSSSDSSSSSSSSSSSDSSSSSSSSSSDSSSDSSSSDSSD
DDDDDDDDDDDDDDDDDDDDDDDDDDDDDSSSSSSSDSDSSSSSDSSSDSSDSSSSSSSSDSSDDSSSSDDSSSSSSSSSSSSSSSSDSSSSDDDSSSSS
DDDDDDDDDDDDDDDDDDDDDDDDDDDSSDDSDSDSSSSSSDSSSSDSSSDSSSSSSSDSSSSDDSDSSSSDSSSSDDDSSSSSSSSSSSDSSSDSSDSS
DDDDDDDDDDDDDDDDDDDDDDDDDSSSSSSSSDSSSSSSSSSDSSSDSSSSDSSSSSDSSSSSSSSSSSDSSSSSSSDSDDSSSSDDSDSSSSSSSDSS
DDDDDDDDDDDDDDDDDDDDDDSSSSSSDSSSSSDDSDSSSSSSSSSSSSSDSDDSSSSSSSSSSSSDSDSSDSSDSDSSSDSDDSSSSDDSDDDSDDSS
DDDDDDDDDDDDDDDDDDDSSSSSSSSDSSSSSSSSSSDDDDSSR......SSSSSSSDSSSSDSSSSDSDSSSSSSDSSSSSSSSSSDDSSDSSSSSSD
SSDDDDDDSSSSDSDDDDDDSDDSSSDSSSDSDSDSDDDSDSDSSS...S.SSSSSSSSSSSSSDSSSSDSSSSSSSDSSSSDSDSDSSSSSSSSDSSSD
SSSDSSSSSDSSSSSSSDSSSDSSSDSSSSSSSSSDSSDSSSSSBSS..S.SSSSDSDSSSSSSSSSDSSSSDSDSDSSSSSSSSSDSSDDSDSSSSSSS
SSSSSSSSDSSSSSSSSSSSSSSSSSDSDDSDSDDSSSSSSSDS.....LGSSSSSSSSSDSSSSSSSSDSDSSDSDDSSSSSSSSSSSSSDSSSSDDSS
SSSDSSSSSDSSSSSDSSSDSSDSSSSSSDDSSSSSSSSSSDSS......SDSSSSDSSSDSSDSSSSDSSDSDDSSSDSSSSSSSSSSSSSSDSSDSSS
SDSSSSSDSSDDDDSSSSSDSSSSSDSSSSSSSSDSSDSDSSDS.......SDSSDSDSSDSSSSSSSSSSSSSSSSDDSSSDSSSSDSSSSSSSSSSDS
DSSSSDSSSSSSSSSSDSSSSSDSSSDSSSSSSSSSSSSSSSSS........LSSDSSSSDSDSSSSSSSSSSSSSSSDSSSDSSSSSDSSSDSDDDSSS
SSSSDDSSSSSSSSSSSDSSSDSSSSSSSDSDDSDSSSDSSSSS........SSDDDSSSSSSSSSSSSSSSSSSSSSSSSSDSSSSSSSDSSSSDSSSS
SDSSSSDDSSSSSDSSSSSSSSSSSSSSSSSDSDDSSSSSSSSS......SSSSSSDSSSSSSSSSDSSSSDDSDDSSSSSSSSSDSSSSSSSSSSSSSD
SSSSSSSSSSSDDSSSSSSDSSSSSSDSSSSSDSSSDDSDSSSSSS.SSGDSSSSSSSSDSSSSSSSSSSDDSSSSSSSDSSSSSSDSSSSSSSSSSSSS
DSSSDSSSDSSSSSDDSSSDSSSSDSSSSSSSSDSSSSSSSDSS.S.SSDSSSSSDSSDDSSSSDSSSSDSSSDSDDSSSDSDSDSSSSSSSSSSSDSSS
SSSSSSSDSSSSSSDSSDSDSSSDDSSDSDSSDSSSSSSSDSSS...SSSDSSSSSSSSSSSDSDSSDSSSSSSSDSSSSSSSSSDSSSSDSSDSDSSSS
SSSSSSSSSSSSSDSDDSSSSSDSSSSDSSSSSSSSDDDSSSS....SSSSDDSSSSSSSSSSSSDSSSSSSSSSSSSSSDSSSSSSDSSSSSDSSDSSS
DSSSDSSSSSSDDSSDSSDDSSSDSSDSSSDSDSSSSSSSS.......SS.SSDDSSSDSSSSSSSSDDSSDSSSSSDSSSDSSSDSSSSDSSSDDDSSD
SDSSSSSSSDSSDSDDDSSDSSDSSSSSSSSSSDSSSSSS............SSSSDSSSSSSSSSSDDSSSSDDSSSSDSSSSSSSSSDSSSSSDSSSD
SSSSDSDSDDSSSSSSSSSSSSSSSSSSDDSSSSSSDDSSSSS.........SSSSSSDSSSSSDSSSSSSSSSSDDDSSSSSSSSSSSSSSSSSSSSSS
SDSSSSSSSSSSSDSSSSDSDSSSSDSSDDSDSSSSSSSSSSSS......SGSDSSSDSSSSSSDDSSSDSSSSSSSSSDSSSSSSSSSSSSSSSSSSSS
DSSDDSSDSSSSSSSSSSSSDDSSSDSDDDSSDSSSSSSSSSSS....SSSSSDSSSDDSSDDSDSSSSSSSSDSSSDSSSSDSSSSSSSDDSDDSDSSS
SDSSDSSSSSSSSDSDSSSSSSSSSDSSDSDDSSSDSSSSSS...S.GSSSSSSSSDSSSSDSSDSSSSSSDSSDSSSSSSSSSSSSSSSDSSSDSSSSD
DSSSSSSSSSSSSSSSDSSSSSDSSSSSDSSSSSSSSSDSS.....SDDSDSDSSSSDSSSSSSSSSSSSDDSSSDSSSSSSSSSSDDSDSSSDSSDSSS
SSSSSSSDSSSSSDSSSSSSSSSSDSSSSDDSDSSSDSSS......SDSSSSSSDSSSSSSSDSDSSDSSSSDDDSDSSSSDSSSSSDSSSSSSSDSSSS
SSSSDSSSSSSSSSSSSSSSDDSSDSDSSDDSDSSSSSR..SSSS..SSDSSSDDSSDSSSSDDSSDSSSDSSSSSSSSSDSDSDSSDDSDDSSSSDDDS
DSSDSSSSSSSDSDSSSSDSSSSSSDSDDSSSSSSSSDS..SDSS..LSDDDSSSSSSSDSSDSSDSSSDSSSSSSSDSDSSDSSDSSSSSDSSDSDDSS
SDSSSSSSSSSSDSSSSSSSSSSDDSSDSSSDSSSSSDS.GSBS..SSSDDS..LSSDSSSSSDSSSSDDSSSSDDSSSDSSSSSSSSSSSSSSDDSSDS
SSDSSSSSSDSSSSSSSSSSSSSDSSSDDDSDDSDSBSS......SSDSBSS...SSSSSDDDSSSDSDSSSSSSSSSSSSSSSSSSDDSSSSSSSSSSD
SSSDDSSSSSDSSSSSSSDDSSSSSSSSSSSSSSSS.........SSSS......LSSSDSSSSSSSSSSSDDDSSSDDSSSSSSSSSSDSSSSDSSSSS
SSSSSSSSSSSDSSSSSSDDSSSSSSSDSSDSSS..........SDSS..SGSS....LDSSSSSSSSSSSSSSDSSDSDDSSSSSSSSSSDSSSSSDSS
SSSSSSSSSSDSSSSSSSSSDSSSSSDSSDSDSS....G...GSSS.L.SSSSS.....SSSSDSSSSSDSDSDSSSDSSSSDSSSSSDSSSSSSSSDDS
SSSSDSSSSSSSSSDSSSDSSSSSSSSSSSSSSSSSGSSS....SR.S.SSSSS.......SDSSSSSSSSSSSSDSSSSSSSSSSDSSDSDSSSSSDSS
SSSSSSDDSSDSDSSSDSSDSSSSSSDSSSDSSSDSSDSDS...S....LSSDSS......LDSSDSSDSSDSSSSSDSSDSSSSDSSSSDSSSSDSSSS
SSSSSSSSSSSSDSSSSSSSSSSSSSSDSSSSDSSDSSSS...SBG...SSSSSS..SS..SDDSSSSSSDSDSSDSDSDDSSSSSSSDDDSSSDSSSSD
SSSSDSSSDDSSSSSSSSDSSSDSSSDSSSDSSSSSSSDS.S.S...GSSSSSSS......LSSSSDSSSSSSSDDDSSSSDSSSSSSDSSSSSSSSSSS
SDSSSSSSDSSSSDDSSSSSSSSDSSSSDSSSSSSDDDSS.....SSSSSDSSSSS....SSSSSSSSSSDSDDDSSSSDSSSDDSSSSSSDSDSSSDSS
SDSSDDSSSSSSDSSSDSSSDDSSSSSSSSSSSSDSDSSSSS.SSSSSSSSDSSS....SDDSSDSSSDSSSSSDDDSSSSSSDSDSSDSSSSSSSSSSD
SSSSSSSSSSSSSSDSDDSDSSSDSDSSDDSSSSDSSSDSSSSSSSDSSSSSSDS....LSSSSSSDSSSDSSSDSSSSSDDSDDDDSSSSDSDSSSDSD
SSSDSSSSSSDSSSSSSSSSSSDSSSSSDSSSSSSSSSSSDSDSDSSSSSSSSSSSSSSDSDSSSDSSSSSSSSSSSDDSSSSSSSSDSSSSSSSSDSSS
ITEM banana 64 41
ITEM banana 67 41
ITEM banana 85 42
ITEM banana 38 43
ITEM banana 0 49
