....................................................................................................
....................................................................................................
....................................................................................................
....................................................................................................
....................................................................................................
....................................................................................................
....................................................................................................
....................................................................................................
....................................................................................................
....................................................................................................
....................................................................................................
....................................................................................................
....................................................................................................
.......................................E..................................................E.........
.....................................EEEEE..............................................EEEEE.......
.....................................EEEEE..............................................EEEEE.......
.............................E........EEEEE....................GGG.....................EEEEEEE......
...............................E......ETEE....................GDDDGG....................EETEE.......
.....................................EETEE.............GGGGGGGDDDDDDGGGG................EETEE.......
...........................E...........T........GG...GGDDDDDDDDDDDDDDDDDG.................T.........
...............................E.......T......GGDDGGGDDDDDDDDDDDDDDDDDDDDG.......GGGGGGGGGT.........
............................E.........GMGGGGGGDDDDDDDDDDDDDDDDDDDDDDDDDDDDG.....GDDDDDDDDDM.........
...GGG..GGGGGGG......................GDDDDDDDDDDDDDDDDDDDDDDDDDDDDDDDDDDDDDGGGGGDDDDDDDDDDDG........
..GDDDGGDDDDDDDGG..................GGDDDDDDDDDDDDDDDDDDDDDDDDDDDDDDDDDDDDDDDDDDDDDDDDDDDDDDDG.......
.GDDDDDDDDDDDDDDDG.................LDDDDDDDDDDDDDDDDDDDDDDDDDDDDDDDDDDDDDDDDDDDDDDDDDDDDDDDDDGGGGGG.
GDDDDDDDDDDDDDDDDDGG...............LDDDDDDDDDDDDDDDDDDDDDDDDDDDDDDDDDDDDDDDDDDDDDDDDDDDDDDDDDDDDDDDG
DDDDDDDDDDDDDDDDDDDDGGGG.........GGDDDDDDDDDDDDDDDDDDDDDDDDDDDDDDDDDDDDDDDDDDDDDDDDDDDDDDDDDDDDDDDDD
DDDDDDDDDDDDDDDDDDDDDDDR..GGG.GG.LDDDDDDDDDDDDDDDDDDDDDDDDDDDDDDDDDDDDDDDDDDDDDDDDDDDDDDDDDDDDDDDDDD
DDDDDDDDDDDDDDDDDDDDDDDDGGDDDGR..LDDDDDDDDDDDDDDDDDDDDDDDDDDDDDDDDDDDDDDDDDDDDDDDDDDDDDDDDDDDDDDDDDD
DDDDDDDDDDDDDDDDDDDDDDDDDDDDDR...LDDDDDDDDDDDDDDDDDDDDDDDDDDDDDDDDDDDDDDDDDDDDDDDDDDDDDDDDDDDDDDDDDD
DDDDDDDDDDDDDDDDDDDDDDDDDDDDDR...LDBBBDDDDDDDDDDDDDDDDDDDDDDDDDDDDDDDDDDDDDDDDDDDDDDDDDDDDDDDDDDDDDD
DDDDDDDDDDDDDDDDDDDDDDDDDDDDDR....L...LDDDDDDDDDDDDDDDDDDDDDDDDSSSDDDDDDDDDDDDDDDDDDDDDDDDDDDDDDDDDD
DDDDDDDDDDDDDDDDDDDDDDDDDDDDDR.......GDDDDDDDDDDDDDDDDDDDDDDDDSSDSSSDDDDDDDDDDDDDDDDDDDDDDDDDDDDDDDD
DDDDDDDDDDDDDDDDDDDDDDDDDDDDDR...GGGGDDDDDDDDDDDDSSSSSSSSSSSSSSDSSSSSSDSDDDDDDDDDDDDDDDDDDDDDDDDDDDD
DDDDDDDDDDDDDDDDDDDDDDDDDDDDR.....LDDDDDDDDDDDDDDSSSSDSDSDSSSSSSSSSDSDSSSDDDDDDDDDDDDDDDDDDDDDDDDDDD
DDDDDDDDDDDDDDDDDDDDDDDDDDDDDG....LDDDDDDDDDDDDSDSDSDSSSDSSDSSSDSSSDSDSSSSDDDDDDDDSSDSSSSDDDDDDDDDDD
DDDDDDDDDDDDDDDDDDDDDDDDDDDDDDG..GDDDDSSSSDSSSDSDSDSSDSSSSSSSSSSSSSSSSDSSDDDDDDDDDSSSSSSSSSDDDDDDDDD
DDDDSDSSSSSSSSSDDDDDDDDDDDDDDDDGGDDDDSDSSSSDSSSSSSSSSDDSDSSSSSSSSSSSDSSDDSSSSSSDSDSSSSSDSSDSDDDDDDDD
DDSSSDSSSSDDSSDDDDDDDDDDDDDDDDDDDDDSSDDSSSDSSDSDSSSSDSSSSDDDSSSSSSSSDSSSSSSDDSSSDSSSSSSSSDSSSDDDDDDD
DSDDSSSSSSSDSSSSDSDDDDDDDDSSSSSSSDSSSSSDSSSSSDSDDSSDSSSSSSDSSDSSSSSSSSSSSDSSSSSSSSSDSSDSSSSSSSSSSSSD
SSSSSSSSSSSDSSSSDSDSDDDDDSDSSSSSSDSSSDSSDDSDSSDSSSSDSSSSSDSSSSSSSSSDDSSSDDSSSSSSSSDSSSSDDDSSSDSSSSSD
SSDSSSSSDSDSDSSDDSDSDSSDSSSSSSSSSSSSSSDSDSSSDSSSSDSSSDSSDSSSSSDSSSSDDSDSDDSSSSSSDSDSSDSSSSSSSSDSSSSD
SSSSSSDSSSSSSSSSSSSSSSSSSSSSDSSDSSSSSDDSSSSSSSSSSSSSDDSSDSSSSDSDSSSSSSSSSSSSSSSSSSSSSDSSSDDSDSSDSDSS
DDSSDDSDSSSSSSSSSSSSDSSSSSSSDSSSSSSDDSDDSSSSSSSSSSDSDSSSSSSSDSSSDSDSSSSDSSDDSDSSSSSSSSSSSSSSDSSSDDDD
DSSDSDSSSSSSSSSSSSSDSSSDSSSSSSSSSSDDSDSDSSSSSDDSSDSSSDSSSSSDDSSSSSDSSSSDSSDSDDSSSSSSSSSSSSSSSSSSSSSD
SSSSSSSSSSSSSSSSSSSDSSSSSSSDSSSDSDSDSSDSDSDSSDDSSSSSSSSDSDSSDSSDDDDSSSSSSSSDSSSSDDDSSSSDSSSSDSSSSSSS
SSSSSSSSSSSSSSSSDSSDSDSSDDSSSSSSSSSDSSSSSDSSSSSDSSDSSDDSSSSDSSDSSSSDSSSSSSSSSSSDDSSSSSSDSSDSDSSSSDDS
SSDSSSDSDDSDSSSSSSSSSSDSSSSSSDSSSSSSSSSDSSSSDSSSSDSSSDDSDSDDSDSSSSSDSSSSSSSSDSSSSSDSSSSDSSSSDSSSSSSS
SSSSSDSSSSSSSSSSDSDDSSSSSSSDSSDSSSDSSSSSSSSDSSSDSSSSDDDSSDSSSDDSSDSSSSSSSSDSSSDSSSSSSSSSSSSDSSSSDDSS
DSSDSSSSSSSDSSSDDSSSDSDSSDSSSSSSSSSSSSSSDSDSSSSSSSSSSSSSSDSSSSSSSSSSSDSDSDSSDSSSSDSDSDSSSDSSDDSSSSDS
ITEM banana 64 15
ITEM banana 1 23
ITEM banana 83 19
