############
#..........#
#..K.......#
#..........#
#....D.....#
#..........#
#..........#
#.......K..#
#..........#
############
